a	a
aː	aː
ã	ã
b	b
c	c
d	d
e	e
eː	eː
g	g
h	h
i	i
iː	iː
ĩ	ĩ
j	j
jː	jː
k	k
kː	kː
l	l
m	m
mː	mː
n	n
nː	nː
o	o
oː	oː
p	p
pː	pː
s	s
sː	sː
t	t
tː	tː
u	u
uː	uː
ũ	ũ
w	w
w̃	w̃
õ	õ
õː	õː
ĩ	ĩ
ĩː	ĩː
ŋ	ŋ
ũ	ũ
ũː	ũː
ɐ	ɐ
ɐ̃	ɐ̃
ɔ	ɔ
ɔː	ɔː
ɔ̃	ɔ̃
ɛ	ɛ
ɛː	ɛː
ɛ̃	ɛ̃
ɡ	ɡ
ɤ	ɤ
ɤː	ɤː
ɤ̃	ɤ̃
ɤ̃ː	ɤ̃ː
ɯ	ɯ
ɯː	ɯː
ɯ̃	ɯ̃
ɲ	ɲ
ɾ	ɾ
ʃ	ʃ
ẽ	ẽ
ẽː	ẽː
