aa	ɑ
ae	æ
ao	ɔ
aw	aw
ax	ə
ay	aj
b	b
ch	tʃ
d	d
dh	ð
dx	ɾ
eh	ɛ
el	l
em	m
en	n̩
eng	ŋ
er	ɝ
ey	ej
f	f
g	ɡ
hh	h
ih	ɪ
ix	ə
iy	i
jh	dʒ
k	k
l	l
m	m
n	n
ng	ŋ
ow	ow
oy	ɔj
p	p
q	ʔ
r	ɹ
s	s
sh	ʃ
sil	sil
t	t
th	θ
uh	ʊ
uw	u
v	v
w	w
y	j
z	z
zh	ʒ
